PPPPPPPPPPPPPPPPPPPPPPPPP
P                       P
P                       P
P                       P
P                       P
P                       P
P                       P
P                       P
P                       P
P                       P
P                       P
P                       P
P                       P
P                       P
P                       P
P              C        P
P           C           E
P                       P
PTTTTTTTTPPPP  TCT T   TP
PPPPPPPPPPPPPPPPPPPPPPPPP