PPPPPPPPPPPPPPPPPPPPPPPPP
P  P                    P
P  PPPPPP               P
P  P     P    P         P
P  P      P   P         P
P  P       P  P         P
P  P         PP    PPPPPP
P  P        P P         P
P  P       P  P         P
P                       P
P                       P
P                       P
P                       P
P                       P
P                       P
P                       P
P                       P
P                       P
P                       P
PPPPPPPPPPPPPPPPPPPPPPPPP